11111111111111111111111111111
10000000000000000000000100001
10000000000000000000000101111
11111110000000000000000000001
10000000000000000000000000001
10000001111111111111111111111
100000000000P01E0000000100001
10000001111111111111110001001
10000000000000000000001111001
10111111110000000000000000001
10000000010000000000000000001
10000000010000000000000000001
10000000010000000011111111111
10000000010000000000000000001
11111111111111111111111111111