11111111111111111111111111111
1C000000000000000000000000C01
11111111111111111111101111101
10011000000000000000001101001
10010010011111111111111111001
10010011110001100E10011110001
100100000001000011100000C0111
11110011111111111110000000001
1000001000C000111111111111101
10111110001110000000000000001
1C001000011111111111110111111
111010000100010000000000C0101
1010111111C101111111111111101
100000000001000000000000000P1
11111111111111111111111111111