111111111111111111111111111111
1C0000000100000100100C00001001
110111110100000010101111101001
110100010111111010101000101001
110001010000001010101011101001
1101110111111011101010100010C1
11010100000E100000001010110001
100101101111111111101110100001
101111100000010001001010001111
1011000100000101100C1110010001
101101010111110100010100100101
1111C10001000C01011101111C1101
100101111101110111000011111101
1001000000000100000000000000P1
111111111111111111111111111111