111111111111111111111111111111
1C0000000000000000000000000C01
111111111111111111111101111101
100000000000000000000001111101
101111100111111111111111111101
1000011110000100E1C01111110001
10010000000100001110000C000111
111110111111111111100000000111
1000001000C0001111111111111101
1011111C1111000000000000000001
1C0010001111111111111111111111
1110100000000000000000000C1101
1010111111C1011111111111111101
1000000000010000000000000000P1
111111111111111111111111111111