11111111111111111111111111111
10000000000000000000000100C01
100C0000000000000000000101111
111111100000000000000000000X1
100000000000000000000000000C1
1C000001111111111111111111111
100000000000P01E0000000100001
10000001111111111111110001001
10X000000000000000000X1111001
1011111111X000000000000000001
10000000X10000000000000000001
1000C000010000000000000000001
10000000010000000011111111111
10000000010000000000000C00001
11111111111111111111111111111