1111111111111111
1000P00100000001
1000000000000001
1000C00111111101
1000C00000001001
1001111110000001
1001111110000001
1001111110000001
1001111110000001
1001111110000001
1111000000000001
1000011111111111
100E000000000001
1111111111111111
