1111111111111111
1000P00100000001
1000000100000001
1000000111111101
100000000C001001
1E01111110000001
111100000C000001
1000011111111111
1000000C00000001
1111111111111111