z111111111111111
1000000100000001
10000001C0000001
100C000111111101
1000000000000101
E001111110000001
1111000000000001
1C00011111111111
10000000000000P1
1111111111111111