1111111111111111
1000P00100000001
1000000000000001
1000000111111101
1001111110001001
1001C00010000001
1000011111111111
100C00000000E001
1111111111111111